###############################################################################
# layout_cryptic_divisions.des: A layout_type_divisions layout for Crypt:$
#                     
###############################################################################


##############################################################
# layout_cryptic_divisions
#
# These are either very randomized encompass vaults, or
# subvault-based layouts.  Take your pick.
#
# Inspired by layout_pan_divisions.
#
# Theses are the only layout_type_divisions layout in
# Crypts and are intended to have a total weight of ToDo.
# If more forms or other layout_type_divisions layouts are
# added to the branch, the existing weights should be adjusted
# to avoid increasuing the total weight.
#



##############################################################
# layout_cryptic_divisions_a
#
# This is the original cryptic_divisions layout.
#
# This layout uses 5 subvaults to place a maze of adjoining
# rooms.  There are 4 quadrants (as in Vaults:$) and an octagon
# for the center.  Subvaults should have randomization and the
# allow_dup tag.  More quadrants and centers are welcome.
#
# Quadrants for this map should have the tag
# "cryptic_division_quadrant_a".
#
# Octagons should have the tag "cryptic_division_octagon".
#
NAME:     layout_cryptic_divisions_a
DEPTH:    Crypt:$
WEIGHT:   9999
ORIENT:   encompass
TAGS:     overwritable layout allow_dup unrand layout_type_divisions
SUBVAULT: A : cryptic_division_big
SUBVAULT: B : cryptic_division_thin
SUBVAULT: C : cryptic_division_small
SUBVAULT: D : cryptic_division_small
SUBVAULT: E : cryptic_division_big
SUBVAULT: F : cryptic_division_thin
SUBVAULT: G : cryptic_division_small
SUBVAULT: H : cryptic_division_small
SUBST: ABCDEFGH = .


MAP
xxxxxxxxxxxxxxxxxxxxxxxxxxxxxxxxxxxxxxxxxxxxxxxxxxxxxxxxxxxxxxx
xAAAAAAAAAAAAAAAAAAAAAAAAAAAAAAAAAAAAAAAAAAAAAAAcBBBBBBBBBBBBBx
xAAAAAAAAAAAAAAAAAAAAAAAAAAAAAAAAAAAAAAAAAAAAAAAcBBBBBBBBBBBBBx
xAAAAAAAAAAAAAAAAAAAAAAAAAAAAAAAAAAAAAAAAAAAAAAAcBBBBBBBBBBBBBx
xAAAAAAAAAAAAAAAAAAAAAAAAAAAAAAAAAAAAAAAAAAAAAAAcBBBBBBBBBBBBBx
xAAAAAAAAAAAAAAAAAAAAAAAAAAAAAAAAAAAAAAAAAAAAAAAcBBBBBBBBBBBBBx
xAAAAAAAAAAAAAAAAAAAAAAAAAAAAAAAAAAAAAAAAAAAAAAAcBBBBBBBBBBBBBx
xAAAAAAAAAAAAAAAAAAAAAAAAAAAAAAAAAAAAAAAAAAAAAAAcBBBBBBBBBBBBBx
xAAAAAAAAAAAAAAAAAAAAAAAAAAAAAAAAAAAAAAAAAAAAAAAcBBBBBBBBBBBBBx
xAAAAAAAAAAAAAAAAAAAAAAAAAAAAAAAAAAAAAAAAAAAAAAAcBBBBBBBBBBBBBx
xAAAAAAAAAAAAAAAAAAAAAAAAAAAAAAAAAAAAAAAAAAAAAAAcBBBBBBBBBBBBBx
xAAAAAAAAAAAAAAAAAAAAAAAAAAAAAAAAAAAAAAAAAAAAAAAcBBBBBBBBBBBBBx
xAAAAAAAAAAAAAAAAAAAAAAAAAAAAAAAAAAAAAAAAAAAAAAAcBBBBBBBBBBBBBx
xAAAAAAAAAAAAAAAAAAAAAAAAAAAAAAAAAA...AAAAAAAAAAcBBBBBBBBBBBBBx
xccccccccccccccccccccccccccccccccccc+ccccccccccccBBBBBBBBBBBBBx
xCCCCCCCCCCCCCCCCCCCCCCCcDDDDDDDDDD...DDDDDDDDDDcBBBBBBBBBBBBBx
xCCCCCCCCCCCCCCCCCCCCCCCcDDDDDDDDDDDDDDDDDDDDDDDcBBBBBBBBBBBBBx
xCCCCCCCCCCCCCCCCCCCCCCCcDDDDDDDDDDDDDDDDDDDDDDDcBBBBBBBBBBBBBx
xCCCCCCCCCCCCCCCCCCCCCCCcDDDDDDDDDDDDDDDDDDDDDDDcBBBBBBBBBBBBBx
xCCCCCCCCCCCCCCCCCCCCCCCcDDDDDDDDDDDDDDDDDDDDDDDcBBBBBBBBBBBBBx
xCCCCCCCCCCCCCCCCCCCCCC.c.DDDDDDDDDDDDDDDDDDDDD.c.BBBBBBBBBBBBx
xCCCCCCCCCCCCCCCCCCCCCC.+.DDDDDDDDDDDDDDDDDDDDD.+.BBBBBBBBBBBBx
xCCCCCCCCCCCCCCCCCCCCCC.c.DDDDDDDDDDDDDDDDDDDDD.c.BBBBBBBBBBBBx
xCCCCCCCCCCCCCCCCCCCCCCCcDDDDDDDDDDDDDDDDDDDDDDDcBBBBBBBBBBBBBx
xCCCCCCCCCCCCCCCCCCCCCCCcDDDDDDDDDDDDDDDDDDDDDDDcBBBBBBBBBBBBBx
xCCCCCCCCCCCCCCCCCCCCCCCcDDDDDDDDDDDDDDDDDDDDDDDcBBBBBBBBBBBBBx
xCCCCCCCCCCCCCCCCCCCCCCCcDDDDDDDDDDDDDDDDDDDDDDDcBBBBBBBBBBBBBx
xCCCCCCCCCCCCCCCCCCCC...c...DDDDDDDDDDDDDDDDDDDDcBBBBB...BBBBBx
xccccccccccccccccccccc+ccc+cccccccccccccccccccccccccccc+ccccccx
xEEEEEEEEEEEEEEEEEEEE...E...EEEEEEEEEEEEEEEEEEEEcFFFFF...FFFFFx
xEEEEEEEEEEEEEEEEEEEEEEEEEEEEEEEEEEEEEEEEEEEEEEEcFFFFFFFFFFFFFx
xEEEEEEEEEEEEEEEEEEEEEEEEEEEEEEEEEEEEEEEEEEEEEEEcFFFFFFFFFFFFFx
xEEEEEEEEEEEEEEEEEEEEEEEEEEEEEEEEEEEEEEEEEEEEEEEcFFFFFFFFFFFFFx
xEEEEEEEEEEEEEEEEEEEEEEEEEEEEEEEEEEEEEEEEEEEEEE.c.FFFFFFFFFFFFx
xEEEEEEEEEEEEEEEEEEEEEEEEEEEEEEEEEEEEEEEEEEEEEE.+.FFFFFFFFFFFFx
xEEEEEEEEEEEEEEEEEEEEEEEEEEEEEEEEEEEEEEEEEEEEEE.c.FFFFFFFFFFFFx
xEEEEEEEEEEEEEEEEEEEEEEEEEEEEEEEEEEEEEEEEEEEEEEEcFFFFFFFFFFFFFx
xEEEEEEEEEEEEEEEEEEEEEEEEEEEEEEEEEEEEEEEEEEEEEEEcFFFFFFFFFFFFFx
xEEEEEEEEEEEEEEEEEEEEEEEEEEEEEEEEEEEEEEEEEEEEEEEcFFFFFFFFFFFFFx
xEEEEEEEEEEEEEEEEEEEEEEEEEEEEEEEEEEEEEEEEEEEEEEEcFFFFFFFFFFFFFx
xEEEEEEEEEEEEEEEEEEEEEEEEEEEEEEEEEEEEEEEEEEEEEEEcFFFFFFFFFFFFFx
x...EEEEEEEEEEEEEEEEEEEEEEEEEEEEEEEEEEEEEEEE...EcFFFFFFFFFFFFFx
xc+cccccccccccccccccccccccccccccccccccccccccc+cccFFFFFFFFFFFFFx
x...GGGGGGGGGGGGGGGGGGGGcHHHHHHHHHHHHHHHHHHH...HcFFFFFFFFFFFFFx
xGGGGGGGGGGGGGGGGGGGGGGGcHHHHHHHHHHHHHHHHHHHHHHHcFFFFFFFFFFFFFx
xGGGGGGGGGGGGGGGGGGGGGGGcHHHHHHHHHHHHHHHHHHHHHHHcFFFFFFFFFFFFFx
xGGGGGGGGGGGGGGGGGGGGGGGcHHHHHHHHHHHHHHHHHHHHHHHcFFFFFFFFFFFFFx
xGGGGGGGGGGGGGGGGGGGGGGGcHHHHHHHHHHHHHHHHHHHHHHHcFFFFFFFFFFFFFx
xGGGGGGGGGGGGGGGGGGGGGG.c.HHHHHHHHHHHHHHHHHHHHH.c.FFFFFFFFFFFFx
xGGGGGGGGGGGGGGGGGGGGGG.+.HHHHHHHHHHHHHHHHHHHHH.+.FFFFFFFFFFFFx
xGGGGGGGGGGGGGGGGGGGGGG.c.HHHHHHHHHHHHHHHHHHHHH.c.FFFFFFFFFFFFx
xGGGGGGGGGGGGGGGGGGGGGGGcHHHHHHHHHHHHHHHHHHHHHHHcFFFFFFFFFFFFFx
xGGGGGGGGGGGGGGGGGGGGGGGcHHHHHHHHHHHHHHHHHHHHHHHcFFFFFFFFFFFFFx
xGGGGGGGGGGGGGGGGGGGGGGGcHHHHHHHHHHHHHHHHHHHHHHHcFFFFFFFFFFFFFx
xGGGGGGGGGGGGGGGGGGGGGGGcHHHHHHHHHHHHHHHHHHHHHHHcFFFFFFFFFFFFFx
xGGGGGGGGGGGGGGGGGGGGGGGcHHHHHHHHHHHHHHHHHHHHHHHcFFFFFFFFFFFFFx
xxxxxxxxxxxxxxxxxxxxxxxxxxxxxxxxxxxxxxxxxxxxxxxxxxxxxxxxxxxxxxx
ENDMAP



# Here in case people want to see or start from an empty
# quadrant for layout_cryptic_divisions_a.  The 'x's are areas that
# are normally not used.
NAME:    cryptic_division_big_base
WEIGHT:  10
TAGS:    cryptic_division_big allow_dup unrand
MAP
...............................................
...............................................
...............................................
...............................................
...............................................
...............................................
...............................................
...............................................
...............................................
...............................................
...............................................
...............................................
...............................................
ENDMAP


NAME:    cryptic_division_small_base
WEIGHT:  10
TAGS:    cryptic_division_small allow_dup unrand
MAP
.......................
.......................
.......................
.......................
.......................
.......................
.......................
.......................
.......................
.......................
.......................
.......................
.......................
ENDMAP


NAME:    cryptic_division_thin_base
WEIGHT:  10
TAGS:    cryptic_division_thin allow_dup unrand
MAP
.............
.............
.............
.............
.............
.............
.............
.............
.............
.............
.............
.............
.............
.............
.............
.............
.............
.............
.............
.............
.............
.............
.............
.............
.............
.............
.............
ENDMAP

